████████████████████
█    $   █    $    █
█        █         █
█        █         █
█    $            H 
█        █         █
█    $   █    $    █
████████████████████